1. Cicaheum - Abdul Muis

70, 69, 68, 67, 66, 65, 1160, 64, 63, 384, 385, 386, 387, 388, 53, 1415, 52, 1416, 51, 1157, 50, 1156, 49, 48, 1155, 47, 934, 46, 45, 44, 641, 642, 1694, 1696, 1695, 1697, 41, 40, 39, 244, 38, 37, 36, 35, 34, 33, 32, 1152, 31, 1392, 30, 1151, 29, 420,  28, 1150, 27, 1149, 26, 1393, 25, 1698, 1699, 24, 23, 22, 1148, 1147, 1146, 21, 1145, 1104, 20, 19, 18, 17, 1778, 721, 1779, 1780, 1100, 1099, 763, 764, 1471, 1472, 765, 766, 307, 1258, 308, 1259, 1260, 309, 310, 725, 1443, 726, 727, 176, 177, 728, 1811, 1810, 1812, 730, 576, 577, 578, 579, 323, 324, 325, 1774

2.Elang - Abdul Muis 

1719, 1720, 1721, 1275, 1823, 1722, 1723, 1724, 1824, 1725, 101, 1726, 1825, 1826, 1819, 1827, 1828, 1820, 1829, 1821, 1830, 1822, 1168, 95, 94, 1831, 1832, 1833, 92, 91, 90, 89, 88, 87, 86, 1163, 583, 861, 862, 1520, 863, 864, 865, 72, 1774, 661

3. Ledeng - Abdul Muis

173, 1197, 172, 1196, 1195, 171, 1194, 170, 1193, 1192, 169, 168, 167, 166, 1191, 165, 164, 1190, 1834, 1838, 1835, 1839, 1836, 1837, 1188, 158, 1813, 1814, 1816, 1815, 1817, 1818, 415, 709, 710, 797, 711, 712, 713, 1430, 714, 715, 804, 805, 806, 369, 368, 1288, 1287, 367, 1286, 482, 366, 1285, 1785, 138,  1760, 1012, 1761, 1221, 205, 1731, 202, 1728, 1729, 1732, 1733, 1734, 1730, 1735, 1766, 1772, 1767, 1773, 1768, 1769, 1262, 314, 1263, 315, 1264, 316, 317, 1265, 318, 1198, 1736, 1737, 1267, 322, 579, 1777, 1776, 1775, 1774

5. Dago - Abdul Muis

1738, 1743, 1744, 1739, 1745, 1740, 1746, 1741, 1742, 1683, 1684, 1685, 1686, 1687, 1748, 1749, 1750, 1751, 1752, 1753, 1754, 1755, 1762, 1756, 1757, 1758, 1763, 1759, 1760, 1012, 1761, 1221, 205, 1727, 1731, 202, 1764, 1770, 1771, 1765, 1735, 1766, 1772, 1767, 1773, 1768, 1769, 1262, 314, 1263, 315, 1264, 316, 317, 1265, 318, 1198, 319, 1736, 1737, 1267, 322, 579, 1777, 1776, 1775, 1774

7. Ciroyom - Antapani

286, 285, 807, 808, 1291, 1290, 376, 375, 1781, 1251, 271, 374, 735, 270, 544, 269, 373, 1487, 479, 480, 481, 260, 144, 369, 368, 1288, 1287, 367, 1286, 482, 366, 1285, 1782, 1785, 1783, 1784, 141, 364, 140, 1012, 1761, 1221, 205, 1727, 1731, 202, 259, 258, 1243, 257, 1242, 256, 1241, 255, 254, 253, 252, 1240, 1239, 251, 250, 1238, 1786, 1789, 1790, 1791, 1787, 1788, 641, 642, 1694, 643, 644, 645, 646, 603, 978, 979, 1792, 1793, 1794, 1795, 1799, 1796, 1800, 1797, 1798, 1233, 235, 1232, 234, 1801, 1802, 1805, 1803, 1806, 1804, 1807, 1808

9. Ciroyom - Bumi Asri

286, 285, 807, 787, 284, 1254, 283, 1253, 282, 281, 1928, 280, 279, 1926, 1927, 1354, 542, 541, 540, 2184, 2185, 2187, 2186, 2188, 2189, 98, 340, 1275, 1823, 1722, 1723, 1724, 2157, 1824, 2190, 2191, 2161, 2192, 469, 1171, 103, 104, 539, 1172, 105, 106, 107, 108, 339, 338, 1274, 337, 336, 1273, 1272, 1271, 335, 334, 333, 1270, 332, 1269, 331, 330, 329, 1268, 328, 327, 326

10. Ledeng - Caheum

173, 1197, 172, 1196, 1195, 171, 1194, 170, 1193, 1192, 169, 168, 167, 166, 1191, 165, 164, 1190, 1834, 1838, 1835, 1839, 1836, 1837, 1188, 158, 1813, 1814, 1816, 1815, 414, 1312, 796, 1311, 1310, 1429, 413, 1309, 412, 1308, 1307, 411, 1306, 1305, 410, 855, 1304, 409, 1303, 1302, 408, 407, 406, 405, 404, 550, 1301, 403, 1300, 1299, 402, 1298, 487, 1326, 1325, 401, 486, 1297, 1296, 400, 1295, 399, 398, 1294, 397, 991, 396, 419, 395, 394, 393, 1010, 1293, 1292, 392, 391, 390, 389, 115, 48, 49, 1156, 50, 1157, 51, 1416, 52, 1415, 53, 388, 387, 386, 385, 384, 63, 64, 1160, 65, 66, 67, 68, 970, 69, 70

11. Ciwastra - Caheum

457, 456, 455, 454, 1438, 453, 452, 1439, 451, 450, 1318, 449, 1317, 448, 447, 446, 445, 443, 1316, 442, 441,  1315, 440, 439, 1314, 438, 437, 436, 435, 434, 433, 432, 1313, 431, 430, 429, 428, 1840, 1857, 2158, 2085, 1841, 1842, 1843, 1844, 1845, 1846, 1847, 1858, 1848, 1859, 1861, 1849, 1862, 1850, 1851, 1852, 1853, 1863, 1854, 1865, 1855, 1856, 1866, 1867, 38, 1868, 1869, 1870, 1871, 39, 40, 41, 1697, 1153, 42, 1154, 245, 43, 1872, 1873, 1874, 1875, 1876, 1586, 1587, 1588, 1877, 1885, 1886, 1887, 1878, 1879, 1880, 1881, 1888, 1889,  1882, 1883, 1884, 1890, 419, 418, 491, 490, 489, 1755, 697, 213, 698, 1891, 1892, 2093, 1893, 1894, 493, 494, 495, 1327, 496, 497, 1328, 498, 1329, 499, 53, 1916, 388, 387, 386, 385, 384, 63, 64, 1160, 65, 66, 67, 68, 69, 70

12. Dago - Caringin

230, 1552, 522, 521, 1345, 1344, 520, 1343, 1342, 519, 1341, 518, 517, 1340, 516, 515, 1339, 514, 513, 1338, 512, 1337, 1336, 511, 510, 1895, 1896, 1902, 1903, 1897, 1904, 1905, 1906, 1898, 1907, 1908, 1899, 1909, 1900, 1910, 1901, 1911, 1912, 1333, 503, 1332, 1331, 502, 501, 1330, 500, 1913, 1914, 1915, 1916, 53, 499, 1329, 468, 1328, 497, 496, 1327, 495, 494, 493, 492, 418, 491, 490, 489, 697, 488, 487, 1326, 1325, 401, 486, 1297, 485, 1917, 1918, 1920, 1921, 1919, 483, 1321, 1320, 1969, 366, 1285, 1782, 1785, 1922, 138, 1760, 1012, 140, 364, 141, 1246, 365, 1970, 142, 1182, 143, 1989, 1990, 1247, 1486, 261, 1248, 262, 1249, 673, 263, 264, 265, 1250, 478, 266, 267, 268, 373, 269, 544, 270, 735, 374, 1781, 375, 376, 1290, 1291, 377, 378, 379, 380, 381, 382, 1923, 1924, 1925, 1926, 279, 280, 1928, 1929, 1931, 1930, 1932, 348, 784, 349, 350, 351, 785, 1933, 1935, 1934, 1936, 1937, 780, 1938, 1955, 1939, 1940, 1941, 1942, 897, 1956, 1943, 1944, 1945, 1946, 1947, 1957, 1948, 1949, 1950, 1951, 1952, 1953, 1958

13. Sadang Serang - Caringin

564, 563, 1381, 562, 1380, 1379, 1378, 561, 1377, 1376, 560, 1375, 1374, 1373, 559, 1050, 1372, 558, 557, 556, 1371, 555, 1370, 1369, 1747, 1748, 1367, 707, 1426, 1518, 1427, 1428, 708, 1303, 1302, 408, 407, 406, 405, 404, 550, 1301, 403, 1300, 1299, 402, 1298, 487, 1963, 1964, 1965, 1960, 1966, 1961, 1967, 1968, 1962, 805, 805, 806, 309, 308, 1288, 1287, 367, 1286, 482, 1969, 366, 1285, 1782, 1284, 1971, 1970, 142, 1182, 143, 1989, 1990, 1247, 1486, 261, 1248, 262, 1249, 673, 263, 264, 265, 1250, 478, 266, 267, 268, 373, 269, 544, 270, 735, 374, 271, 1251, 272, 273, 811, 274, 275, 1411, 276, 1412, 277, 1972, 382, 1923, 1924, 1925, 1926, 1927, 1354, 542, 541, 540, 2184, 2185, 2187, 2186, 2188, 2189, 68, 340, 1275, 341, 342, 1276, 343, 115, 114, 113, 734, 112, 1177, 1176, 111, 110, 1174, 1175, 1173, 109, 339, 108, 107, 106, 105, 1172, 539, 538, 537, 1353, 536, 1352, 535, 534, 1351, 533, 1350, 532, 1343, 531, 1348, 530, 1347, 529, 528, 527, 1346, 526, 525, 524, 523

14. Karang Setra - Cibaduyut

1834, 1190, 162, 163, 831, 161, 160, 1596, 600, 599, 1391, 1973, 1974, 1975, 1976, 598, 1977, 1979, 1978, 830, 596, 595, 594, 1015, 593, 1014, 592, 749, 591, 1980, 1982, 1981, 1983, 1984, 589, 546, 688, 373, 1487, 479, 480, 481, 1985, 1986, 1987, 1988, 1989, 1990, 1247, 1486, 261, 1248, 262, 1249, 673, 263, 264, 265, 1250, 477, 476, 475, 356, 357, 856, 857, 858, 1519, 859, 860, 775, 584, 1163, 85, 84, 1478, 580, 865, 73, 74, 75, 76, 1385, 1991, 1992, 2001, 1993, 1994, 2002, 1995, 1996, 2003, 2004, 1997, 2005, 1998, 1999, 2000, 2006, 1383, 1382, 565

15. Cicadas - Cibiru

2007, 2010, 2011, 2012, 2008, 2009, 2013, 239, 240,241, 242, 243, 244, 1868, 1867, 37, 36, 1864, 1854, 35, 34, 33, 32, 1192, 31, 1392, 30, 1860, 1151, 29, 420, 421, 422, 423, 424, 425, 426, 2014, 2043, 2015, 2016, 2017, 2018, 2019, 2020,2021, 2022, 2023, 204, 2025, 2026, 2027, 2028, 2029, 2030, 2031, 2032, 2033, 2034,2035, 2036, 2037, 2038, 2039, 1573, 915, 916, 1574, 917, 1055, 1056, 1057, 1646, 1647, 1058, 1648, 1059, 1649, 1060, 1061, 1062, 1063, 1064, 1065, 1066, 1067, 2389, 2390,2391, 2394, 2395, 2396, 2397, 2398, 601

17. Elang - Cicadas

474, 473, 2269, 342, 1276, 343, 116, 1117, 1178, 118, 2280, 119, 120, 121, 344, 1719, 540, 541, 542, 1354, 543, 278, 383, 1252, 1972, 277, 1412, 276, 1411, 275, 274, 811, 273, 272, 1251, 271, 374, 735, 270, 544, 545, 1355, 546, 588, 373, 268, 267, 266, 478, 1250, 2665, 264, 263, 273, 1410, 627, 1409, 671, 1408, 670, 361, 1282, 886, 887, 1115, 1116, 1117, 1767, 2343, 1118, 1119, 1094, 2344, 2353, 2345, 2346, 2354, 2355, 2347, 2348, 1240, 2349, 2356, 2357, 2350, 2358, 2359, 1787, 2351, 1788, 2352, 1872, 641, 642, 1694, 643, 644, 645, 2360, 2363, 646, 603, 978, 979, 1792, 244, 1868, 1867, 37, 36, 1864, 1854, 35, 34, 33, 32, 1152

18. Cibaduyut - Caheum

2044, 2051, 2045, 2052, 2053, 2046, 2054, 2047, 2055, 2048, 2056, 2049, 2050, 565, 1382, 2057, 2106, 2031, 2081, 2082, 2058, 2059, 2060, 2061, 2061, 2062, 2063, 2064, 2065, 2066, 2067, 2068, 2069, 2070, 2071, 2072, 2073, 2083, 2074, 2075, 2076, 2077, 2078, 2079, 2080, 2084, 2085, 1841, 1842, 1843, 1844, 1845, 1846, 1847, 1858, 1848, 1859, 1860, 30, 1861, 849, 1862, 1850, 1851, 1852, 1853, 1863, 1854, 1864, 1865, 1855, 1856, 1866, 1867, 38, 1868, 1869, 1870, 1871, 39, 40, 41, 1697, 1153, 42, 1154, 245, 1872, 1873, 1874, 1875, 1876, 1586, 1587, 1588, 1589, 1877, 1885, 1886, 1887, 1878, 389, 1155, 48, 49, 1156, 50, 1157, 51, 1416, 1416, 42, 1415, 53, 54, 55, 500, 1913, 56, 57, 58, 59, 1158, 60, 61, 62, 384, 63, 64, 1160, 65, 66, 67, 68, 2369, 69, 70

19. Ciroyom - Caheum

286, 285, 807, 808, 1291, 1290, 376, 375, 1781, 1251, 271, 374, 735, 270, 544, 545, 1355, 546, 589, 1984, 590, 720, 748, 591, 749, 820, 750, 1013, 751, 802, 1483, 1484, 1485, 803, 1185, 151, 1186, 152, 798, 153, 154, 417, 155, 156, 1187, 2199, 2202, 2203, 2200, 2204, 2201, 2205, 414, 1312, 796, 1311, 1310, 1429, 413, 1309, 412, 1308, 1307, 411, 1306, 1305, 410, 855, 854, 2087, 1367, 1748, 1425, 1424, 706, 705, 1423, 704, 703, 995, 1422, 70, 1421, 2323, 701, 2088, 2091, 2092, 2089, 2090, 2093, 1893, 1894, 493, 494, 495, 1327, 496, 497, 1328, 498, 1329, 499, 53, 1916, 388, 387, 386, 385, 384, 639, 65, 66, 2420, 67, 68, 2369, 69, 70

20. Ciwastra - Cijerah

457, 456, 455, 454, 1438, 453, 452, 1439, 2266, 451, 450, 1318, 449, 1317, 448, 447, 446, 445, 444, 443, 1316, 442, 441, 1315, 440, 439, 1314, 438, 437, 436, 435, 434, 433, 432, 1313, 431, 429, 428, 1840, 1857, 2158, 2159, 2160, 677, 678, 679, 680, 1440, 297, 298, 299, 300, 301, 302, 303, 304, 2094, 2105, 2095, 2096, 2097, 2098, 2099, 2100, 2101, 1811, 1810, 1812, 2103, 2104, 1992, 2001, 1993, 1994, 1995, 1996, 2003, 2004, 1997, 2005, 1998, 1999, 2106, 2107, 2134, 2109, 2110, 2111,2112, 2113, 2135, 2114, 2115, 2136, 2137, 2116, 2138, 2139, 2117, 2140, 2141, 2118, 2119, 2120, 2121, 2122, 2123, 2142, 2143, 2124, 2144, 2125, 2145, 2126, 2127, 2146, 2147, 2128, 2129, 2148, 2149, 2150, 2130, 2151, 2152, 2131, 2153, 2132, 2133, 2154, 1272, 1273, 336, 337, 1274, 338, 339, 108, 107, 106, 105, 1172, 539, 104, 469, 1171, 1170, 2155, 2156, 2157, 1824, 2190, 2191, 2161, 2162, 2163, 2173, 2174, 2164, 2165, 2166, 2167, 2168, 897, 2169, 2175, 2170, 2171, 2176,2177, 2178, 2179, 2180, 2172, 2181, 2182, 2183

21. Sederhana - Cijerah

1482, 800, 801, 751, 802, 1483, 1483, 1484, 1485, 2193, 2194, 1493, 820, 749, 591, 1980, 1982, 1981, 1983, 1984, 589, 546, 588, 373, 269, 544, 270, 735, 774, 271, 1251, 272, 273, 811, 271, 275, 1411, 276, 1412, 277, 1972, 1923, 382, 1924, 1925, 1926, 1927, 1354, 542, 541, 540, 2184, 2185, 2187, 2186, 2188, 2189, 68, 340, 1275, 341, 2269, 342, 1276, 343, 115, 114, 113, 734, 733, 732

22. Ciroyom - Cikuda Pateuh

286, 285, 807, 787, 789, 785, 351, 350, 349, 784, 783, 782, 892, 781, 781, 1938, 780, 1937, 779, 778, 777, 776, 775, 584, 1163, 85, 84, 1478, 774, 773, 80, 772, 771, 770, 769, 1477, 1476, 768, 1475, 767, 571, 1474, 572, 573, 1473, 574, 575, 730, 729, 728, 177, 176, 727, 726, 1443, 725, 310, 309, 1260, 1259, 308, 1258, 307, 766, 765, 1472, 1471, 764, 763, 1099, 762, 2429, 761, 1470, 1469, 1468, 760, 2196, 2198, 2197, 2195, 753, 1460, 752

23. St Hall - Ciumbuleuit

1079, 1080, 358, 669, 359, 1278, 1277, 360, 1407, 1279, 1280, 1281, 361, 1282, 886, 362, 363, 1283, 364, 141, 1246, 365, 1970, 142, 1182, 143, 1989, 1990, 1985, 1986, 144, 369, 145, 1183, 370, 1363, 549, 1362, 146, 1665, 147, 1184, 148, 1666, 149, 150, 1185, 803, 1485, 2193, 2194, 1493, 820, 750, 1013, 751, 801, 800, 1482, 799, 824, 823, 798, 153, 154, 417, 155, 156, 1187, 2199, 2202, 2203, 2200, 2204, 2201, 2205, 414, 1312, 796, 795, 1481, 794, 1480, 1479, 793, 792, 791, 790, 789, 788

24. Sarijadi - Ciroyom Via Setrasari

2206, 2207, 2208, 2209, 2220, 2221, 2222, 2210, 2223, 2211, 2224, 2212, 2225, 2213, 2214, 2226, 2215, 2227, 2216, 2228, 2229, 2230, 2217, 2231, 2232, 2218, 2233, 2219, 1503, 834, 833, 2234, 2238, 2235, 2236, 2239, 2237, 1390, 1973, 1391, 1974, 1975, 1388, 598, 1977, 1979, 1978, 830, 596, 595, 594, 1015, 593, 1014, 592, 749, 591, 1980, 1982, 1981, 1983, 1984, 589, 546, 588, 373, 269, 544, 270, 735, 374, 1781, 375, 376, 1290, 1291, 808, 807, 285, 286

25. Sarijadi - Ciroyom Via Sukajadi

2206, 2207, 2208, 2209, 2220, 2221, 2222, 2210, 2223, 2211, 2224, 2212, 2225, 2213, 2214, 2226, 2215, 2227, 2216, 2228, 2229, 2230, 2217, 2231, 2232, 2218, 2233, 2219, 1503, 834, 833, 2234, 2238, 2235, 2236, 2239, 2237, 1390, 1973, 1391, 1974, 1975, 1388, 598, 1977, 1979, 1978, 830, 829, 1502, 1501, 2298, 1482, 800, 801, 751, 802, 1483, 1484, 1485, 2193, 2194, 1493, 820, 749, 591, 1980, 1982, 1981, 1983, 1984, 589, 546, 588, 373, 1487, 479, 480, 481, 1985, 1986, 1987, 1988, 1989, 1990, 1241, 1486, 261, 1248, 262, 1249, 673, 263, 264, 265, 1250, 478, 266, 267, 268, 373, 269, 544, 270, 735, 374, 271, 1251, 272, 273, 811, 274, 275, 1411, 276, 1412, 277, 1972, 382, 1923, 1924, 1925, 1926, 279, 280, 1928, 281, 282, 1253, 283, 1254, 284, 787, 807, 285, 286

26. Tegalega - Cisitu

2240, 2241, 78, 1162, 79, 773, 80, 772, 81, 82, 904, 83, 1478, 84, 85, 1163, 584, 775, 585, 586, 475, 356, 357, 856, 1079, 1080, 358, 669, 359, 1278, 1277, 360, 1407, 1279, 1280, 1281, 670, 1408, 671, 1409, 672, 1410, 673, 263, 264, 265, 1250, 478, 266, 267, 268, 373, 1487, 479, 480, 481, 1985, 1986, 144, 369, 2301, 2302, 2305, 2306, 2307, 2308, 2303, 2309, 2310, 1320, 1321, 483, 1322, 1323, 484, 1324, 1917, 485, 486, 401, 1325, 1326, 487, 1298, 402, 1299, 1300, 403, 1301, 550, 404, 405, 406, 407, 408, 1302, 1303, 409, 1304, 855, 1517, 851, 1516, 1515, 853, 1514, 1513, 852, 851, 2251, 2263, 2252, 2253, 2262, 2261, 2254, 2255, 

27. Ujung Berung - Ciwastra

437, 438, 1314, 439, 440, 1315, 441, 442, 1316, 443, 444, 445, 446, 447, 448, 1317, 449, 1318, 450, 451, 2266, 2246, 2247, 2248, 2249, 2250, 2265, 2264, 2251, 2263, 2252, 2253, 2262, 2261, 2254, 2255, 2260, 2256, 2257, 2259, 2258, 1619, 1004, 1620, 1005, 1006, 885, 884, 1551, 1550, 883, 1549, 882, 1548, 1547, 1546, 881, 1545, 880, 1544, 879, 1543, 1542, 878, 1541, 877, 945, 1540, 876, 1539, 1538, 875, 874, 1537, 873, 1536, 1535, 872, 1534, 1533, 1532, 1531, 1530, 871, 1529, 1528, 1527, 1526, 1525, 870, 1524, 1523, 1522, 1521, 869, 868, 867, 866, 1633, 1634, 1635, 1636, 1637, 1638, 1638, 1640, 1579, 927, 2242, 1580, 928, 929

28. St Hall - Dago

856, 1079, 1080, 358, 669, 359, 1278, 1277, 360, 1407, 1279, 1280, 1281, 670, 36, 1282, 886, 362, 363, 1283, 364, 141, 1246, 365, 1284, 1782, 2311, 1785, 1922, 138, 209, 1555, 210, 211, 212, 1225, 697, 213, 214, 215, 1051, 553, 216, 992, 217, 218, 219, 1367, 220, 1368, 554, 221, 1554, 222, 2425, 223, 224, 225, 1226, 226, 227, 228, 1227, 229, 1553, 230

29. Gede Bage - Elang

2242, 2244, 2243, 2245, 1579, 926, 1578, 925, 1577, 924, 1576, 923, 1575, 922, 621, 647, 620, 919, 918, 1055, 2416, 917, 1574, 916, 915, 1573, 914, 614, 615, 616, 617, 618, 619, 620, 621, 1006, 885, 622, 623, 624, 625, 626, 2322, 627, 628, 629, 630, 631, 632, 633, 634, 635, 636, 637, 638, 676, 2160, 677, 678, 679, 680, 1440, 681, 682, 683, 684, 685, 686, 687, 913, 912, 1572, 1571, 911, 1570, 1569, 910, 909, 1568, 908, 1567, 907, 1566, 906, 1565, 1564, 1563, 905, 1204, 1203, 183, 182, 181, 180, 1202, 2100, 2101, 1811, 1810, 1812, 730, 576, 577, 578, 579, 1777, 75, 2240, 76, 1385, 1991, 1161, 1386, 77, 2241, 78, 1162, 79, 773, 80, 772, 81, 82, 904, 903, 902, 901, 900, 899, 1562, 898, 1561, 897, 1942, 1560, 896, 895, 894, 781, 892, 891, 890, 97, 2189, 98, 340, 1275, 2269, 1276, 343, 116, 117, 1178, 2280, 119, 120, 121, 344

30. Ledeng - Margahayu

173, 1197, 172, 1196, 1195, 1171, 1194, 170, 1193, 1192, 169, 168, 167, 166, 1191, 165, 164, 1190, 1834, 1838, 1835, 1839, 1836, 2281, 2282, 2283, 831, 161, 160, 1596, 600, 599,  2289, 2290, 2285, 2291, 2292, 2293, 2286, 2294, 2295, 2296, 2287, 2297, 1498, 1499, 827, 1500, 828, 1501, 2298, 1482, 800, 8001, 751, 802, 1484, 1485, 803, 1185, 713, 1430, 714, 715, 804, 805, 806, 2299, 2300, 2301, 2302, 2305, 2306, 2307, 2308, 2303, 2309, 2310, 2304, 2311, 1785, 1922, 138, 208, 137, 1181, 136, 135, 941, 940, 939, 938, 986, 985, 984, 2325, 2312, 2314, 2315, 2316, 2317, 2313, 1590, 935, 1589, 1877, 1885, 1886, 1887, 2318, 47, 934, 46, 45, 44, 43, 641, 642, 1694, 1696, 1695, 1697, 41, 40, 39, 1871, 244, 1868, 1867, 37, 36, 1864, 1854, 35, 34, 33, 32, 1152, 31, 1392, 30, 1860, 1151, 29, 420, 421, 422, 423, 424, 425, 426, 2014, 2043, 2015, 2016, 2017, 2018, 2019, 2020, 2021, 2022, 2023, 2024, 2025, 2026, 2319, 2320, 2321, 2322, 627, 628, 933, 1585, 1584, 932, 1583, 1582, 931, 1581, 930

31. Dipati Ukur - Panghegar

1424, 706, 705, 1423, 704, 703, 995, 1422, 702, 1421, 2323, 2324, 1052, 1051, 553, 552, 1366, 1365, 551, 1364, 550, 1301, 403, 1300, 1299, 402, 1298, 487, 1959, 1963, 1964, 1965, 1960, 1966, 1961, 1967, 1968, 1962, 805, 806, 2299, 2300, 2301, 2302, 2305, 2306, 2307, 2308, 2303, 2309, 2310, 2304, 2311, 1785, 1922, 138, 208, 137, 1181, 136, 135, 941, 940, 939, 938, 986, 985, 984, 2325, 2330, 2326, 2327, 2331, 2332, 2328, 2333, 2329, 2334, 133, 1180, 258, 259, 202, 1764, 1770, 1771, 1765, 1735, 2335, 2338, 2339, 2336, 2340, 2341, 2342, 2337, 2343, 1118, 1119, 1094, 2344, 2353, 2345, 2346, 2354, 2355, 2347, 2348, 1240, 2349, 2356, 2357, 2350, 1789, 1790, 2358, 2359, 1787, 2351, 1788, 2352, 1872, 641, 642, 1694, 644, 645, 2360, 2363, 2364, 2361, 2362, 976, 975, 974, 973, 972, 2366, 2367, 2368, 2369, 69, 70, 2370, 2372, 2371, 2373, 968, 1601, 967, 966, 865, 964, 963, 962, 961, 950, 959, 958, 957, 956, 866, 867, 868, 869, 1521, 1522, 1523, 1524, 870, 1525, 1526, 1527, 1528, 1529, 871, 1530, 1531, 1532, 1533, 1534, 872, 1535, 1536, 1537, 874, 875, 1538, 1539, 876, 1540, 954, 953, 
1600, 952, 951, 950, 949, 948, 947, 946, 945, 944, 1598, 943, 1597, 942

32. Dago - Riung Bandung

230, 1553, 229, 1227, 228, 227, 226, 1226, 225, 224, 223, 2425, 222, 1554, 221, 554, 1368, 220, 1367, 1748, 1425, 1424, 706, 705, 1423, 704, 703, 995, 1422, 702, 1421, 2323, 701, 2088, 420, 700, 1054, 1419, 699, 1418, 1891, 1892, 2093, 1893, 1894, 493, 492, 418, 419, 395, 394, 393, 1010, 2374, 2377, 2375, 2376, 1621, 2378, 2379, 2380, 2381, 2382, 2383, 1604, 987, 938, 986, 985, 984, 2325, 2312, 2314, 2315, 2316, 1592, 1593, 1594, 1595, 937, 982, 981, 2384, 2387, 2385, 2386, 2388, 248, 247, 1236, 246, 245, 43, 641, 642, 1694, 643, 644, 645, 2360, 2363, 2364, 2361, 2365, 2362, 976, 977, 1602, 1603, 978, 979, 1792, 244, 38, 1867, 37, 35, 1864, 1854, 35, 34, 33, 32, 1152, 31, 1392, 30, 1860, 1151, 29, 420, 421, 422, 423, 424, 425, 426, 2014, 2043, 2015, 2016, 2017, 2018, 2019, 2020, 2021, 2022, 2023, 2024, 2025, 2026, 2319, 2027, 2028, 2029, 2030, 2031, 2032, 885, 1006, 1005, 1620, 1004, 1619, 1003, 1618, 1617, 1002, 1616, 1001, 1615, 1614, 1000, 1613, 1612, 999, 1611, 1610, 998, 1609, 997, 996

33. Cimindi - Sederhana

2399, 2400, 1045, 1044, 1632, 1631, 1043, 1630, 1629, 1042, 1041, 1628, 1040, 1039, 1038, 1037, 1114, 1113, 1112, 1671, 1111, 1670, 1110, 1109, 2401, 2406, 2407, 2402, 2403, 2408, 2409, 2410, 2411, 2470, 2404, 2405, 2412, 1689, 1690, 1691, 1692, 1021, 743, 744, 745, 746, 1458, 1459, 1022, 747, 748, 1980, 591, 749, 592, 1014, 593, 1015, 594, 595, 596, 830, 1978, 597, 1387, 1977, 598, 1388,1389, 1390, 1391, 1974, 2284, 2288, 2289, 2290, 2285, 2291, 2292, 2293, 2286, 2294, 2295, 2296, 2287, 2297, 1498, 1499, 827, 1500, 828, 1501, 2298, 1482, 800, 801, 751

34. Panyileukan - Sekemirung

2413, 2415, 2416, 1055, 918, 919, 920, 947, 921, 922, 1575, 923, 1576, 924, 1577, 925, 1578, 926, 1579, 1640, 1639, 1638, 1637, 1636, 1635, 1634, 1633, 866, 956, 957, 958, 959, 960, 961, 962, 963, 964, 965, 966, 967, 1601, 968, 969, 2417, 2418, 2419, 2420, 66, 65, 1160, 64, 63, 384, 62, 61, 1159, 60, 1158, 59, 58, 57, 56, 1913, 1914, 1915, 1916, 499, 1329, 498, 1328, 497, 496, 1327, 495, 494, 493, 492, 418, 491, 490, 2424, 2423, 2422, 2421, 698, 1418, 699, 1419, 1054, 700, 1420, 2088, 701, 2323, 2324, 1052, 1051, 553, 216, 992, 217, 218, 219, 1367, 220, 1368, 554, 221, 155, 222, 2425, 2426, 2427, 2428, 1686, 1687, 1369, 1370, 555, 1371, 556, 557, 558, 1372, 1050, 559, 1373, 1374, 1375, 560, 1576, 561, 13778, 1379, 1380, 562, 1381, 563, 564

35. Gede Bage - St Hall

1059, 1649, 1060, 1061, 1062, 1063, 1064, 1065, 1066, 1067, 2389, 1068, 1069, 604, 605, 606, 607, 608, 609, 610, 611, 612, 613, 914, 614, 615, 616, 617, 618, 619, 620, 621, 1006, 885, 622, 623, 624, 625, 626, 2322, 627, 628, 629, 630, 631, 632, 633, 634, 635, 636, 637, 638, 639, 676, 2160, 677, 678, 679, 680, 1440, 297, 298, 299, 300, 2473, 2485, 2484, 2474, 2483, 2482, 2475, 2476, 2477, 2481, 2478, 2479, 2480, 17, 1778, 721, 1779, 1780, 1100, 1099, 2429, 2430, 2432, 2431, 1396, 656, 2433, 2434, 2435, 1096, 2436, 2437, 2438, 2439, 2440, 1093, 127, 1094, 128, 129, 1179, 130, 200, 201, 259, 202, 1219, 203, 1220, 204, 2441, 2442, 2443, 1761, 1012, 1011, 1244, 1245, 886, 887, 1115, 1556, 1557, 1558, 888, 1559, 889, 668, 669, 359, 1278, 1277, 360, 1407, 1279, 1280, 1281, 670, 1408, 671, 1409, 672, 1410, 673, 263, 264, 265, 1250, 477, 476, 475, 356, 357, 856, 1079, 1078

36. Gunung Batu - St Hall

2400, 1045, 1044, 1632, 1631, 1043, 1630, 1629, 1042, 1041, 1628, 1040, 1039, 1038, 1037, 1114, 1113, 1112, 1671, 1111, 1670, 1110, 1109, 2401, 1034, 1033, 1032, 2444, 2445, 2446, 2447, 2470, 2404, 2405, 2412, 1689, 1690, 1691, 1692, 1021, 743, 744, 745, 746, 1458, 1459, 1022, 2448, 2452, 2449, 2450, 2451, 2453, 804, 805, 806, 369, 144, 1987, 1989, 1990, 1247, 1486, 261, 1248, 262, 1249, 673, 263, 264, 265, 1250, 477, 476, 475, 356, 357, 856, 1079, 1078

37. Sadang Sernag - St Hall

1332, 1331, 502, 501, 1330, 500, 1913, 1914, 1915, 1916, 2461, 1415, 52, 1416, 51, 1157, 50, 1156, 49, 48, 1155, 2086, 47, 2462, 1878, 1879, 1880, 1881, 1888, 1889, 2374, 2377, 2375, 2376, 2378, 2379, 2380, 2381, 2382, 2383, 1604, 987, 934, 1124, 1123, 2333, 1122, 1121, 1243, 258, 259, 202, 1219, 203, 1220, 2441, 2442, 2443, 1761, 1012, 1011, 1244, 1245, 886, 887, 1115, 1556, 1557, 1558, 888, 1559, 889, 668, 669, 359, 1278, 1277, 360, 1407, 1279, 1280, 1281, 670, 1408, 671, 1409, 672, 1410, 673, 263, 264, 265, 1250, 477, 476, 475, 356, 357, 856, 1079, 1078

38. Sarijadi - St. Hall

1125, 1126, 1677, 1127, 1676, 1128, 1674, 1129, 846, 844, 843, 842, 848, 849, 850, 1507, 840, 1130, 2463, 2464, 2465, 2468, 2466, 2467, 2469, 2470, 2405, 2412, 1689, 1690, 1691, 1692, 1021, 743, 744, 745, 746, 1458, 1459, 1022, 1667, 720, 1981, 1983, 1984, 589, 546, 588, 373, 1487, 479, 480, 481, 1985, 1986, 1987, 1988, 1989, 1990, 1247, 1486, 1248, 262, 1249, 673, 263, 264, 265, 1250, 477, 476, 475, 356, 357, 856, 1079, 1078